pfl: vll tqs
kzc: jsx npb nbn xdx czg
qdp: mlk bvr
rqp: tsq ssm
zqb: txj
psd: ptf zsk fkv rdb
vzb: vvb
zkd: pqc xrz
ztp: hhg xdx jzq ptd xpg
rgg: sdn sfx pzn xpg stz
lqv: hpk smj ccr
mnj: klc
txk: tcg mkl
grp: hhd jvf zjt mzr
nkh: lpj zvn lrr grd
knn: kfd jkf btq
cll: bpn
xdd: xcn zvh dkd
mdr: nvl
tmv: gqt lhv
xzm: sxf bvp
ksc: pvs bnp
czd: jxf nsj fql qks
zbp: tpt ssj pch qcx fcz
mrx: xgm tbj
dgk: fjt fkn qsm gmv
scm: cbj xfv vth
fbm: xjz hxp
qbm: tlh
zts: zmc
bgr: cxm fvv
rmb: sgd zzz bgv
vcx: mpd qxg
rxn: zvb hrl
ppt: rtg
ktr: zgl
zcr: jkc xvv zss
mpd: xbb qsd tpt
tmc: hkz
cgl: slk zpr prb
sfc: fzm
xxn: fvs xrz
tfb: nbx ntg
kfs: rbg bkd cvd cvs
gcg: nlc czx nzp chj
vpx: fqf qvg zcc
mxs: ldr csq
lmz: qtv cmx mct xnm
cfc: fhl
qtv: pvr
kdn: npq
tpt: scz
tbl: tpl fdf vdh brd jfx ssj
jvz: pbc
bkv: zhg xkj hlr ghg
xdl: fhq pjr gdt
nbn: mmf
nrd: rfd hpm bvr
snn: qvt nkj vbc
dgc: mvb zdm mrx
hnm: hpd gkn
tbq: rfh sml zxs nlk zrm fqs
bfx: zxk ftn jzg
jrp: dkj hpm
clz: rdr qfm fdc
rsc: xsf clb rjb fbm
nkn: sfx cfm
glx: rxq brk qhq xqc
mmp: lth mvl jht mjt tmv
jhx: ccr ccd rtf txj
zmj: lgk
mjz: hrh ljp ksc czs
nqs: grf kgd
tmq: ndz hzc
zft: ltx jnb sht cqs bdn
cqk: cps rsq hnm qtk
shg: pzn zxp scq tlv ngl
qzk: frl cmx gmq fmn
cbf: nrf sfj
klq: rqv xsf vzv
qph: rrh ndz hkq hkz
nhc: mjk vgp qks
sff: hrq sll rgc
pvx: gcz sjf
qqk: rmn
qks: pvr
qxx: zvn clc
hqd: pdz xnm
lcb: bkl jlr
mhx: skx rpl qml
cfm: fql pvs
jgv: jgt bkn ztq lzh
xlc: qbq bxz
jfk: hdk
cps: hpx qbq fgm vmh
gxs: xbr
khn: tlc
njm: hxf glt
sxx: spb pgm
fkg: rtf
qhx: tmp qqk hrq
nbv: nqn fvb zpl fmt
pcl: vrb
tsf: tkf rml zbh ljr
cvq: fvp sdj xct
zbn: rpz qml bjm prt
chc: fjf kqk tjp
kbg: djs jkg hrx
mtf: mbm srn fnq
qkd: ngg sqs fkx mgl hlq
cpc: qfm xrj
kmb: mbm fvv fxl
lnd: rbq vqs
rcj: hzc hxl hhg qcg
dzh: bjq dpc jdk xns
xcq: znv
gzp: mjk bvg qss zcs
npm: rdd lxb dfk pgg gjv
jhz: jvb vrb
sph: rfd xnd vxl spx
fqf: rsv qxg
bhp: rrd tpb rmx ptx hjv
sdp: gxz cps qtt gcv
dvz: mpp rsx ctv
jth: nbn khn jbg tmc vvg
sjr: gjg sql rvl bxx skn
dgp: fsc dzc glh sfx
cvs: mgl xqg rqv qxx
rtg: vxd qvg sgd
hpx: mpp lkp kcz
mbs: qmg dgg knj nht
cfj: nqj bsh mhb mhg jdq
mgt: skx rck xqk jzp
mfx: zkl rgz tmp
lsq: drg gcb zvh
vjf: dtg tmq cvq
thj: hxd cbf zgl jpv
hnx: hrg zpj klf mfx
bbs: hrh zjb tcc vvg
cgc: rxq
nqp: sxx
nmm: pqm tbc
lzm: bjb rcr pnj
bng: grf
chf: gxs cds cpc qbj
qtk: lkn rjb rpp
krp: bjb lqh snj njm
fzb: ntg sgj gpz
grd: xcq mvg ncn
ggs: qss vcz nml hxl zbr zgh nht ggf
btq: ngg
zxp: zjb
qnz: xvc hqd pgg lqb
jsq: klc fxg tcg
qpb: fqr gbd ngv
xcs: hth czg
nbx: lxs ncn
bxs: lhb rrd cgg
zmb: txk tpt tgj hfz
njz: xfj
phc: tps rml qgz
rnz: mhv cnx jhh lsd rlp
pzt: vmz nkc hzc
hvv: gcz
qtm: dsl mrq pgx
tcb: rdk sxk
ltv: jxf kzv mjj
nqj: hhd xcq qrb sxk
rtl: cds jkc ctv
rpl: ckl hrq
jlr: tfg vlv
gsb: kxt jlb tkd
hpf: cgq mtd
vbm: jpl nkn
qmx: zpj pch sfj
qjk: kfg zgd
kpl: vxd sqj cvd rdf
lfl: rjb zfk
krk: pfl fxg hcm mrb
jpm: mqb
lmv: cqv dlr
csn: rxh bdg gtj lmp
mlv: mqk tjp ggf
txl: xjz
bcl: zvb qpr
zkl: lpj vvs
ksp: cdh fdc qhx mxl
bhn: clx hkq hzc gkf
ckz: dqg msh
hbx: fxf hfb xcm
kdx: hnm bkd ddm
qhq: zrm hfj
rcr: lpf tbj
fjv: lrx xqc zqz gfd gkg thp rtc
ztr: kzz qbh khg rcc
qbf: qfb fql
xdh: prp
kvz: qsd bdq qbq hfg
gdt: bjt bjq qsl
fpr: fzp psk hbh btl nvl
rhm: cfh tsb
hpz: nvg lgc
ths: gsf fkg htx xgm
pnx: vsr dqd zqh kkl sps mkq
xqm: mvd rrz mdr ncg
tks: frx
mrn: ksc vhp tss
qqt: dkj
bjb: npq
xgn: bkl sbj
bfj: glm brj fvs rxn
lrr: mxs ljr zvq
gqt: xrz
nrf: hfb
jtq: gtd hgs rps
zxr: hqz zsh fzl cgq
vmz: lbt cll
rrd: cgg bjq kbf kqk
pxt: czz dxt lnd lrx
mvb: qtv
fmz: gjq vdh vll bms
fkf: mzr brj gjq
xnd: sml
frx: mqk ccr pdz
ztt: mts cfh ftk
jxf: tvg zxh bpv
cjs: qmf zzd sxf
cxp: qdf
stt: vbm mfl
rlh: mzq ztm
sdn: qqt lhb
lpf: pxx cmb
hkm: qml rqv
csh: hxp fkn gfv zcr
brq: vzb zxf kgf
hfz: tbh mkl
fcm: clb zsl fzb dmx
dfj: kxv lhr dqj ksj
nhb: qgz fzm gxv
gfd: vqq rrh
kxr: vzt nxl ppf hrg
jkc: fxt xbp
bmr: zpj ppj fkx kpt
bnt: qnf zjt ctg sxc
ccc: jhh fql chj
zzd: rvz sql zts
mrb: csg
xjl: gjx
qds: fbm vtt
tpb: fvb
tjh: rlp hhv jhg
lsb: grz pjr tnr
nbm: txl
jvk: mfl jgp
rdz: pdg gfn sbj
nkg: mct nqn zpq mqp
krg: qhk bxz fqr
zrm: vlv dxb
mct: lrx vvb vsr
hhr: hkb lkp grp jfk
kcv: tfr jlr shf nht zzq
hxx: zvh gqd hkb ldr
crh: xbd pnj xnm
rpj: cfr cqv
lkn: jtx kxt ltb sbd pfl
jmd: qdb vth
fnq: rbt
lnt: ltl
rsv: jrh
frl: xfv ghg nfs
xqc: vth
rpz: qmf qls tcb
ptf: zpj ddm
vbv: lmp htd jfd
mvx: fxl sgp qxh
fnt: jls ftk brq qks pdg
gmz: sxc
fxg: qtt
kdr: rpg xqc cnz hpf qbf
bgd: qxh vll mqb vnz
zbh: dmg bxz
jvp: zgz tlp mbt
gmp: lbs
nht: cdt ggp
rxv: hvv lhc zgd
plt: msh bck hdx tcb
gmq: vfs txj
gqk: sbj kdn zqh
zxg: vfj bxb vnv
hbm: vsp klf pqc nhq
jmz: hkq djs mkq
fzm: dqg
rdk: ppf
mgx: tkd vzt
kxt: lzc jtx
csg: mbm
crc: tcb fcm ksg
fqg: tlr ppz zdc
ngd: vcx lkp cbf xqk
xvf: bnp grf
slc: gpz zmj hfg
gkc: mvl cdl zvh zsk
hqv: kmb mvt fxf vnz
hrq: xfk
rfh: bkl
jht: rxn mfx dpg
tsn: msh btq qrf mvt
hbz: czx
vgq: ksg fmb
svh: ffb qpf rmn vsv
lmk: xvf pfp
zdj: sxj jbg bfx
lnp: xfj
ppn: lxv lcq mlp xrj
cfr: xjz rck
rfc: fnf dnz rrn
fkv: tbh
rrz: vzb vmz njz
sds: gmz pgm fdf gpf mxs hmg
cdx: ghm pxx stt ggp
rps: gcs lnp sht
tvg: mbn zpq hxf
vcm: snj rxv nqt tsb tfr
zhs: nqp xzm cvz jzp jjq
psk: vsr jmd tnr
ftm: ntg trv nqp
chz: fxg
dgn: spv dxt tcc
rvh: tps slt rdb bxz
szf: mvd jrp tpb fcf fkg trr
ttr: qss qzg
mnb: rhm mhv qql
vcz: cfp
jgn: lhc shk njm
vdh: gqd
tvf: qrb ztm
mrv: hds lpk clx nbn kzv hpz
pjr: fff
qtt: tmd
nkc: nvr
rxl: kph
cdl: znh
ssd: dfk
xbl: crc lrr xgp rdk
pnt: gmz gtj fnq zmj
jsx: qnh kdn rfd
vcp: qct kgs hpm
sdj: xhx cgg
nmh: nlm jzq ptc glt
tvc: xvs cvz
xsf: nxj bkd lhv
tnp: mlk zqb tvh
mnq: brx ljj pmb grf kqk
dnv: nfl bbx dpg cds
sgp: csg lcq csq
sxj: gcz xnd
ptd: vsm cnj
gxk: vmh gpz bqv gxs
bkl: qct hpb
ssh: dmx bdt
mhv: rzt
fmb: kdj bkn srn
zpl: tbq hrh
gql: ztt czz zps xct
zvv: rlp nkz cgq
knj: mdm lqh kfg
jhb: prb bdv hrl
nhp: lnd jvb fmf bng
tsz: qkq rhv ngp xfv
rjc: ssd cgc zcs gjx
znk: fkv ppt zlr qbj
zmh: zpq rql
lhq: bxx mzh
zfj: rdr fxf qds ffb
tmh: cmb
tpn: gxv fgf vcm
tgs: tcc hfp
rvl: rsh pxh znv
jkg: lqb smj
htf: hfj nkz lpp
xbj: vxd hbg bsh
rbv: cll czz kfv spx
ljd: qbf mvb brf ghg
tgz: zmc fqf gqd kpt fhk nmm shz jjm
slm: prp jqq mzq
rgz: zxx jrh
lbt: blz jgp rrx
hbg: jkf
xsq: xbb
dlr: lgk
vbc: cfp hpk
vcg: frz
bqx: jjq ksl rtj
ptv: ksl
tzb: dmg
vnz: mzr
gvr: kvq zbp sfc hrc
bqs: chc nml lcp klm
bdj: lcp bpn rqr hbz zcs dnz
tkd: zss
slv: gfd hkv fgf fmd
mbt: cqs qhq vvb
htj: bhg xgn mrf jzg zxs lpp
skx: xbb
pnd: zvq sxc tck jdf
xqg: mzr
znv: mzq skx jrh
mjl: sjv ghg hkq hpz
kfv: xdx ljd rfh ngp
ltb: rzs
kgb: tlv sxs lsr zqb
zjs: tmr cxr cqd ssj
hfg: zfk tmp
ctr: tmh gmp bmk cfp tfr
xkj: gjv rmx rbq
bbx: vpx
nvg: dkj
lvd: qqt npb mvb
rbg: gbd gsd
ppj: qxg
bdt: lzp
jdk: fzl zqq tpb hpb
sqj: kbl rsh
trj: qvg nhb cdh
xpg: glt npq
cfk: lkd zxs kfg nvr
nfl: ppj
vfz: xvh xct grf
thz: jcq hpf jvb bkl
tgj: srn
kll: ngg trj lmv rdk
brs: mmf ttr shf lhb
brx: vsj cxp
zbr: zxp fmg lcv
ztq: bgv blr
xvh: cfp
ngv: drg xbp clc
fzp: qdj vrb
xhr: vvx nfs jls
srg: lnp
hdx: nxx ssj vvs
frs: zrm lsb ljh frb
sfx: cfg
gps: rtf
fpd: dgc rrn jgz vcg
vhg: vvb xkd spx nts
hxm: cvb xfv
spk: zdm lgc
pqk: hsl hff ddm
bmb: tvh vlv xmq
ggf: zgz
qxh: nbx zpr
xft: ztq gqt znv
rgm: klq qnf rdk njp dcf
zld: zvb xxr gmv jtl mjs mhx
bpd: jvp dzj djs gsh
fth: hnm lkp
tbf: fjm hsl blk gqt
dmj: dqj txl bgv
xsx: hzq sdj tks gtd
cth: kdx vzt kvq rmb
tvh: dcd
vvb: dbm
skh: zjt hdg brj rdk
clb: fxl fxt
sjv: hbz
zlm: ksj bbr sfc
fxf: tmd ltb
jqg: ckl rgc
vtt: sqj gqt fsb lkz
qvg: lxs
tkf: lnn xsq mgl
vvg: fvb
rzt: clx hxq
glm: jsq qrf mfj
htr: brx nvv vrq
ptc: hfp qzg zxk
zrz: zqz zxp sxs rfc
bzx: zxg nbl gcv jjm hxp dpg
rqm: lmp jql ctv sbd
kkd: ztm kph jfk jnv
pdf: ctr qdp jmr dfk
tjr: zlr hht zss tzk
xmj: dnc qdp
vhv: hcj ktb lxb zhg
fdb: mzr ztq bsh
btl: qqt zdb hfp
bdv: rtl xrz
vxd: bcd qhk gfv
npg: scz xsq qrb tqs
kgh: hrx vbc kds gqk hgs
vqt: zhv
jhf: mhz mlk
ntg: nhq gbd
xkd: cqj
zth: hgk tfb xkg gbz
hds: cfp mkq sgb
dxh: mzh lfl qls nrc
frz: bxs qgh
vpm: mnj zpr dmg
gmv: lzc
vmf: zps gcm nhc dtg
tkh: ppf fth zgl pqm
tqn: sxs glh hll vcq
xjr: fzp xbd pzt mts
pfp: snj mst tfg
glh: qlq
vmn: fjn drg nmm lps rcc pqc
lbs: jvb
rtj: tzb
mdm: dcd qbm
kgz: ztm jvg hgq dqj
fcf: qdb
hrx: dtg ptx
rcq: tzk tps qhk zkl
chj: flm
hmd: ssd zcs
jmr: qdj
hkb: brp
stz: gmp qrv
mlg: hll fsr ptd pcl lbs mkb
trr: xct gxc
hqz: bjb qsl
jls: mmb nzx
hxq: txl
qsb: ckl zsk gsd
ldz: xvh svq sdn
dpg: jgt
fdf: gbz vsv
tdx: tmr hff
xhg: jsz nvr tnp scq crh cvb
lgb: hkz nht tmq
lbn: ppt jvf hrc gkq
nzb: tfg zhz qkq zmh
zxx: sfj lhv
jjm: vdh
sqs: tdx fzm bjm
kkb: xkg fmx mzs
bck: qpb qls jzp
qbj: bdt jkc
lxb: vbm zcm
pdn: cvz dkd hfz gbd
scz: sbd
kfg: jmd
jdf: qqk mdq rpj
lqb: tfr pcl
nzp: hxq xkd
vth: hpk
xsk: fkn cmg fkh tlr
sps: mct fjf
lcv: rdd
kkl: dnc xfv mjr
qmg: frx rqr
sgb: ccc mlv qgh
dnc: nlc
fjj: lns gjg
mmf: spv sxn
phm: bqv tkp qmx klc
bhk: qqk ktr msh vqt
hhg: ftn
cgh: qdb fmn tsk xjl rqp
rmx: rqr cnx jgp
jql: fjn
fzz: fkn vgq xbp jqg
xgd: mrh sqj qcx
fhl: fff
vvx: tsb zdm qsl lhc
gxc: rtc
rks: vlr ncn bvp
vfj: kph tcg nhq vll
mcl: dvl hcm bxb
nqn: cnz ftn zjb
htp: mbn ptx lmk hmd
xzn: hdf rpl fdb mvl nfl
tlp: bpv jzq
cht: tqn lvd nqs djm
bpv: brf
ctp: khx dfk flm sxn
zhp: crs cvd ksj zdc
fmd: sxn
mfc: mpj lfl tmv tmd
pfr: mnj rgc trv
bkb: dqj brd vlr zsk
flm: qzg
nss: prb hdg rck
hxl: kqk
xlr: pqg ljh cvb rcj
fpg: xbr dzx
hvd: crh nvg tlp fzp
gtc: csg lxt tps jxk
qqs: nbg hfp vhp
dxt: fcf dnc
gcb: hpd fkv
nfs: cbj
fjg: qgz lhq fpg
zlr: lnn
qkq: rtt grc
fgf: gjx mrs
sll: dqj
mjx: jhf qql ngl vcz
cbb: cfm sct kgs htb htr
rdf: hgk shn krg fqx
bbj: kvk hbx pgx
cvb: pzn
cqh: prb zsl lth scp
cfg: bnp
fjm: fsb mtf bdg
lkz: cdl mjt
zbc: pgx tbh bdt
rrn: glt
kvq: mrb sgd mqb
mmb: lsf fzp xvh fmd
njv: mrs tbq dxb sps mtd
jtd: kvs qbh rzs gzm lxh
qfx: spk hxm bdn
zcj: rtt jtl zbc bms lhq
qmm: nkc nkz
hqt: nss djd prp vpm
djd: jkf zrr dqg
sql: qtt jhk
zvq: scp
gvs: lmv hcm ptv mbm
ngp: gmq dmp
ggp: hrh sxn
bkq: tvf ckh bbj rpp jjm
kdp: chz zpj gxs ksl
gsf: xmq
ffb: vnv
gsh: cgc qjk tjp kzv
hpm: cqs hxf
zxd: dmg rbt jvs mrq
mst: nvv nts qdf
mhh: zgz nvv hzc jvm fff
fmn: cfc rql
tqs: zhv tbh
hdf: jvg rsv
kvk: zxx dzx
bst: qjk cdt xvc lcb
xrj: hcm
ckm: zds qlq vqq tlc rql
jgp: rdd
gcj: blr zcc qpr fgm fjt mvt
cnz: dmp vcz
rsq: lgk fkn jtx
qdj: npb
tmg: tnt bmr mfj ppj
jvs: rcc
vqk: jvg rtl mdq chz
crs: mlp rxl
qcx: fqx vvc
bnx: jfx vnv qrc rzs
hrl: bms ldh
nzx: dkj jgn zqh
jhh: rrn
fqs: clx gjv fmg
qnf: qmf lzc
gcs: pdg bkl jcq snv rdz
cdt: mdr qss
gsd: nhq
vtj: bdv fkv rxh tbc
bmn: jfk mkl fgm bbx
zxf: hzc jrm lcp
sbv: jql mcl bsh
hlz: lgk tps
rmz: rtf mhz jzg blz
jpk: cqv cfr hgk
snz: bkd hrl fcz
thl: bvm xbr bqv xfk vcx tmr kcz
scp: jbp
vrq: fmf nfs bdn
ssm: jmd qkt
rdd: cqj
jbh: lhf hfb ltl khg
xpc: xbb
rzs: gcv
mlp: hrc
lhb: xfv vfs xhx
kbf: pfm ftn
fmf: flm
hkv: cfh tkc stz zsg cxs
xcp: pmb xmq
zcm: qdf cll
svq: pvr jmr pjr
cxr: ssh gxz xxn
zzq: jvk hlr nnk
kzb: jpl hvl qkt zcs
nbl: jbp zcr
cdh: scp jql xbj
tnj: pxx fmg
nld: xdh xcn lnn bdg lkz
nbg: gcz
tnr: rtc jhg
ngl: tsb
pxf: zkd kvk vsv
ccd: xnd gcz lpk
kdj: xbr sql spb
vkp: ktb ffg smj pvx
sxq: jrm mhv hhv xvh
lcs: gps qtv dnc
fdc: prp lfv
xqf: xgp xfk vqc ssj
kgd: gxc
xbr: xqg
fnh: zxs kgs hzq lmk
kzz: xgd nbm fjj
hbh: fhq rfc
xsg: nxj fkf pqk hxd ssh
zhb: fhk jpm jqq
xfj: djm thp
bjm: qxg pqm
ldh: zzz
kxm: rvk bdj jbg
bkn: qfm btq
ljh: jmr sjv
rbq: pdz
sjt: hhv vfs
stn: ngv kcz slz
gfv: mgl
vlr: fth ltl
brk: dxb cmp
zch: rhm qbt jhz zmh
vhp: njz jrp nbg
bfk: fvp btg
kbl: xvs zvb
fgm: dmx
snv: mqk hvv fbr
dzj: gps lcs
qtc: kgd dqd bjt
hsl: nqp sfj tgk
bcd: lnt mfj
dbm: mhz
qcg: xtg nbg
jnv: ckz zpr
blz: vqq
cmg: xkg znh xth
nrp: lhv
mhg: qfm vgb cxm cqh
cvm: xkh bqv gbd rtj
lqh: blx
ncq: blx mts kbf vqs gmq
mrs: pgg
rrh: spx nvl
fsb: vzt
shz: pgm rsx
dbz: rcc sbd bdq rlh
fkd: ccc lrx vln qdp
kds: mjr htf pvx
xxj: mrh qhb mrl vbl
vkq: qql mvd tnj tlh
cds: qpr
xkp: fjj rqv rlh krg
tkc: tmc bvr
fhq: tmc
xvj: slk qbj xbr klf
hgk: qrf
smr: jhk
xtg: gfn dxb hmd
hht: lnt xdd zqc
npt: hlq ljr clc hsq
dzc: fcf
nlk: kzv jmd
dgg: jgp jgz zgd fnf
lgc: lpk
fvb: bpn
qpf: ckl fqr
rzh: vfz vvb rnz
mrq: ktr zcr
mmx: pmb hxf lkd spv
mvg: ptv fmx
vsp: ktr bmr
rlp: shk sjt
mlh: qfx qbt zxf gqk
xdv: xtm drt kgf
zgd: pxx
zqr: czs cmx lcb rpg
hsq: grp mdp gsb
vqc: jgt xpc
kfq: jsz qzg
xsz: bcl drg gcb mfp vjp
ctg: bdg rgc
brj: hrc mdq
bjq: tmh
tlb: htp xgm shq lzm hbz
dsl: gkq dzx
qvt: jvn spx shs
brf: grc
mxl: zts pqc
bxb: csq
mkl: jsq
slt: xrj tzb
zgh: kcv xdv
tps: kph
pzv: kxr bfd lsq sxf
npr: njm pvr qqs brf gkf
fkh: jvs pxh nhb zmc
gfq: jpm gkc ftm kfs
frm: fqr rks rxn ckh jnv
mzs: fmx knn fhk
kft: lkd xjr jkg fkg
jnt: thl qpf kfd qds ctv
vtg: cxp jmd vrb zqh
zqz: sdj xvf spv ljp
ksj: mvg
gjc: vth cfc gmq
shq: sxj pnj jhz hkz
vrn: ncn sgj ltt mdp kfd
xlh: zsg dxt nkj lcv
zxz: ckh pxf zhv cqv bdt
ghm: cmp nkn
rfd: dbm
jpv: sxk znh bkn
tzk: lmp
zpr: tnt
mrh: tmp zvh
shn: msh qmx ksg dcf
jxd: lcq hgm hkm rpj rvz
ddm: scz
shs: khn gfn kfq
lnf: cxp nnk ghg ccr qlq
vdz: qnh czs vfs mqp
ffx: slz slk
phs: qlq pfm xkq kdr
vbl: psd qgc rdg
vvc: cqd slz
xth: qtm zvq mrb cfr
lsf: vxl grc
rhv: dcd clx
xdx: rbq
lrn: zlr kxt zmc cds
mpf: fmf lcv nsj lnp
dvl: jsq tsf
lkp: lxh
nqt: jvb mlk
pmb: sjf
jzj: kvs hxd slm lpj
jnc: klm qdj vvg
hmg: vzv qrb zth
hjv: mkb sdj zqz
krl: jdq qrf jjm fjg
jvm: lpf mfl mbn
mjt: xbp txk
lhj: fql bhg cnx
ncg: hxl ssm
vnm: bvr rzt jhf hxl mqk
zhz: jnc hqz mqp
gxz: qrb
qgz: shz
rpg: pgg
pch: gpf nrp
qkt: bhg sml
htb: crh ghm vlv
nkq: vxd fvs mnj xvv jlb
lcp: vcq
lkd: zhg gkf
grm: ghm sjt kxm jhz tlv
tck: cvz sll zkl
djl: nbg htx trr
zmc: tmr kmt jbp zcc
hrf: chj lsr ndz pcl
fjn: qhb ppf
xkg: vvs
rsh: ctv
hxp: xvs qml nrp
sct: vcg blz lpk
kpt: zvn
xxf: xmj zjb vcg gkg dtg
mnp: hkb sfc qls jnv
vzs: ppt lxs zqc vnv bdv
mjr: rfd
ftk: pqg xtm
vln: vqq tnj bjb
pmx: btg qmg qql
zht: ckz xpc zrr
ndz: sbj
qbh: qcx pxh qxx
cmb: qdb
qmf: tbc
lsd: dzc rtt zrm
hfj: nnk bpv qgh
dvh: tmd
rvk: zqq cqj
clh: srg djm jbg zpq
zxh: dcd xjl
sjf: jsz
cmx: dlc hqd
lns: xfk rxh rsx
lhr: zqc tlr
bmz: dcd tmc sjf vsr
qhb: gpf hff
jbg: vcq fbr
ltt: xqk fnq
kzv: zdm
zqh: vbm
hvl: lgb dzj htx rfh
jnk: pxt zsg pdz
shk: snj
fqx: mzr tmr
cqv: lcq hgk
cnx: fhl
mkm: qgc cqv sqj
jgt: pqm
qnh: lbt qks
qrv: xcs zxf bmb hlr
jjq: fcz rbg jbp
kvs: hpd dcf
dkd: tvf srn
tlv: ptc dgn
xns: qdf vxl mkq
zsn: kcz sgd bmr lth
bcc: zgh dnz dlc htx
fvv: ldh rzs
zdc: ffx dzx
hfb: sll cqd
tfm: btg djl ljp hbh jlr
zbb: rxl rbt
sbj: npq
hhv: jsz cqs
txj: lrx
bxx: tmd
ltx: vsm cmx nkj
xfb: dvz xvv blr kfd
fvs: rxh rbt
lfv: ngg jvs vqt
drt: gjx hpb
jhv: tkd lhr glm hlz
tkp: prb fxt bcd hrg
jfd: hlq lhr bxx
bbr: ckz tfb nbl zss
mtd: fcf
blk: ppf jzp
mzb: cpc zbp bxb rml
ssj: jkc
kph: fmx
cnp: njp smr kvq dsl xft
mjs: dkd sbv vfj
nlm: lgc xhr jvk
hlq: xbp hpd
rtp: qtc lsf ncg
lpj: ldh
mvd: ndz cmp pbc zxh
xcn: rzs
sxd: smr fhk rck tkd rdb
gtd: sjv gxc
mrp: clc bfd jpk zts zsk
ctf: gmp grz tvg sxn
jgz: cqj lgc
zfk: gkn klc crs fsb nbm
vzq: tvc scn txl mxc
khg: tlr rks kcz
dcx: lxb tjh ksc sjt dqd
mjk: mbn bfk
jcq: cgg
qpr: xjz
zhq: nvl jvn tgs bvr
xfq: sjf zxk dgp xdl
vlv: nvg
rmn: zsl xlc
mjj: rps tpn
vzv: hbg
zsg: xjl
dvk: gpz bfd rbt jql
tmr: rdb
sfj: tbc xjz
gxv: sgj fxl
qsd: tnt
xbd: snd
hzq: rrx
tbj: ssd
cnj: rbq xgm jvz
gtj: slt mrb
hsk: sjf jrm hxf pdg kfg
gjg: sgj
kmk: zhq jbg zgz
tsq: ckm qjk jvn
mkb: djm drt ggf khx
ksg: dvh
zkn: fvv lth sff lzc vll
blx: tcc
mqp: njz
qsl: jhz
pgx: sxf
bjt: cbj
dqd: snd
lbv: pmx qmm frz tsb
clg: hrc mgl chz gfv
xcm: gjq jnv qtt
scq: czg
frb: pnj
bgj: xxn slc jrh vzv xpc zkd
njp: zzd qqk mxl xcq
pqg: fmd
vsj: fvp tnp rrx
fmt: rtt tkc lqh
lxt: njp ppj xdh
gbz: xqg zgl
zjt: rbg
gpz: brd tgj
vgp: xxb zps cfc fjf
gkg: hpb qfb
lxh: bxx ldh
tgk: xvv ptv rgz
vcq: czx
bvm: slt zvh sxx
klm: jzq mbn
cxs: rrn vvg
lsr: czg nlk jhh
fjt: bcl dxx hff
nxx: zsl spb
dqg: dlr
bnp: vks
xtm: dbm
xxr: sxx xzm
hvm: kkb vpx qxg
prt: bgv spb
jpl: nlc fjf
scn: csq bgr phc tdx
ldr: tbh lmp
hfp: lpp dkj
pfc: nfl tpt tzk xdd gxz
dcf: rpp
pml: dvh mpp nxj vvs
hjh: sbd hbg qgc smr
mts: cqj pbc
nml: fsr cfg
nsj: bjt vfs cll
bdq: tvc xfb
lps: ldh jvg tcg
xxb: rfh lnd ggp
mrf: gjc lpp kbg
hlr: kgs
fgt: vqc jhb mgx frm hdk
sxf: lgk
pfm: rtf
ptk: fpg rtj vqt rtl
lhc: tmh
hhd: xdh
hcm: jvg
mpj: lzp vqk blk hvm
jxk: gmv tsn
fsc: xcs vvb sml
jhk: srn kbl
qfb: mhz
jlb: zhv gbd
qbt: jzg
gzm: xvs zht qtk
zqc: rxl
ffg: jmz snv ngl glt zds vks
khx: mdm mrx
tss: qbm hhg bdn fmg
fqr: vvc bms
skn: jkf drg xkh
mzh: dpg
qjs: jrm glh nkj rdd
jvf: csg jxk
tfg: cfh
ktb: dzc rql
zrr: xfk jfx
ttb: jvk xcp pvs mjj chc
ptx: bhg
lhf: xfb dlr jpv
nxb: htf grc hrx lhj hvv blz
nts: scq mfl
sxs: zps
nlc: pnj
qhk: bxx
fnb: xnm tfg zgz bvg
mgl: xbb
cmp: pzn
jmx: shf dmp rrh hxq
tlc: mdr
lqg: zvv rhv rrx
nrl: nbm dqj tfb xgd
nxj: tnt
pkh: gcz bng xgn nzp qbm
xkh: nmm
gjq: fkv
rdr: csg zbc
nzz: dvl sgd zlm tlr ljr
ppz: rtj xxr mgx
mdp: jjq cds
zcc: lnn
tlx: ffx stn vnv mkm
mfp: hdg kpt rsx
djs: pzn qkq gfn
rmq: srg gkf htx
gcm: nvr hxm cxs jvz
tpl: bvp jxk rvz
trv: zzz hlz
fjq: vcp cll nqs cgc snd
hqr: lhc pfm rvk
nvc: zzq hzq bpn qbt
dxx: fxt mzh lfv zlr
vsm: kgf nqt
bfd: rxh hdk
vmh: tmg bgr
xqk: mdq
tgf: jvn jnk gcs zds
lxv: vnz zmj ldh
vhn: npg bqx tzb mvx
pgm: zvn
jqq: vgq vqc zhv
mhb: nxx bqv gjg
grz: frb tvh mrs
thp: ptx
bmk: fhl qmm jhg jtq tks
xvs: xrz prt
qhr: fnh kmk blx kfq
cxm: hkm lxs
ffk: ppt jgt hfz hdf
shd: xbd khx xmj tgs
mfj: fmx
mdj: mtd zqb jvk kdn tjp
fbx: zvn zbh tmd gpf
tlr: ksl
shf: tbj vbc
blr: mzq rsh
hxd: jqg xkh hdk hfb
cgq: xcs
dmp: hgs nbg
dpc: ldz kfq rcr
ljj: czg qgh fhq mjr
rjb: xcn gpf zvh
xvc: brk bfk qct zhg
tqm: nvv hqr gsf
fzl: nkc vks
xhx: tlh
hgm: gcb qmf tgj
mxc: nrf lnt
smj: xtm qfb czx
xph: rpg ltv bng kks zcm hfj
blj: prb zbb rpp cjs
mqb: gxz hhd mvt
nrc: rdk brd clz mpp
zsh: thp frb jhz
hrh: tlc
hgq: rml skx mdq
htd: jfx gmz sqs
zdb: pbc shk sbj
bvg: snd hpk fnf
qsm: pxh kdx fjj
vsv: ltb zsk
fbr: pfm
rvz: kmt
znh: qbq ncn
mjm: vks zqq hgs vcp
pkz: tlh rqr snn lqv
dlc: jhg xkd
nxl: tmp jtx
fhx: vzb zpl lbs jcq
ncn: dmx
kmt: hff gkn gjq
btg: cbj nnk
xjm: tqm stt vqs cfg zdj
xgp: zcc qsd
czz: npb fbr hll mqp hpb czs
hcj: grz vsr xgm
rtt: qkt mdr gps
brp: jkf mvl hlq
hvs: xft vsp cvm jpm
qgc: rsv mpd zbb nxl
kxv: dmx cvz zzz ffb
sxc: fcz lgk
sht: hfp gps
rsx: gkn
vjp: hpx lnn xlc dfl
jsc: rgc xsq mxl snz
lzh: nrp cbf ctg
hjq: kgf hkq fnf vqs
ztx: klf kfs fqg fkx
qzd: gcv dlr bbx vmn
jnb: zds rmq nkz
cbj: bng
gqd: cvd
hrg: qsb
xmq: fhl
tsk: xcp srg mjk mvb
dfl: gsd sgp dmj xlc
mrl: ltt hqt rbg sbd
vsf: dnz lqb gsf pcl
jdq: hkm cdl dvh
vgb: nrf sxk qvg
lzp: cqd ltl
jtl: zzz qmf jql
tdz: zhb mxc pfr cgl
pvs: rtc
rdg: lkn ptf vbv
qlz: pqg tks xdv vfz
hth: xnm pfm cmb
hll: jmd
rxq: qqt qct hxf
gkq: zcr mlp
lxl: rtp rzh khn fsr
kzs: vxl vjf qdb srg mpf
fvp: xhx
fkx: rdk
smq: vxl bfx vzb gcg
kks: cfh qkt zdm
tdb: zqq spk rrd rgg jvz
rcl: ljp jbg nrd qcg tpn fsr scm mnb
hdg: ckh
pgk: zlr slz xfk fkv
xkq: fff lqg tsk
zxk: jvz
jbk: zdb gjv mrn rqp
mjq: cmx dgc kgd mjl ttr
qrc: gjq zvn bvp
frf: qfm slk prp xsq
